20 40
35
240
1000
09 09 09 09 09 09 09 09 09 09 09 09 09 09 09 09 09 09 09 09 09 09 09 09 09 09 09 09 09 09 09 09 09 09 09 09 09 09 09 09
09 01 00 00 00 00 00 00 05 05 05 05 05 00 00 00 00 00 00 00 00 02 00 00 00 00 00 00 00 00 00 00 00 00 00 00 05 05 05 09
09 00 00 00 00 00 00 00 05 05 05 05 02 00 00 00 00 00 00 00 00 00 00 00 00 00 00 00 00 00 00 00 00 00 00 00 05 05 05 09
09 00 00 00 00 00 00 00 05 05 07 05 05 00 00 00 00 00 00 00 00 00 00 00 00 00 00 00 00 00 00 00 00 00 00 00 05 02 07 09
09 00 00 00 00 00 00 00 05 05 02 05 05 00 00 00 00 00 00 00 00 00 00 00 00 00 00 00 00 00 00 00 00 00 00 00 05 05 05 09
09 00 00 00 00 00 00 00 05 05 05 05 05 00 00 00 00 00 00 00 00 00 00 00 00 00 00 00 00 00 00 00 00 00 00 00 05 05 05 09
09 00 00 00 00 00 00 00 05 05 05 05 05 00 00 00 00 00 00 00 00 00 00 00 00 00 00 00 00 00 00 00 00 00 00 00 00 00 00 09
09 00 00 00 00 00 00 00 00 00 00 00 00 00 00 00 00 00 00 00 00 02 00 00 00 00 00 00 00 00 00 00 00 00 00 00 00 00 00 09
09 00 00 00 00 00 00 00 00 00 00 00 00 00 00 00 00 00 00 00 00 00 00 00 00 00 00 00 00 00 00 00 00 00 00 00 00 00 00 09
09 00 00 00 00 00 00 00 05 07 05 05 05 00 00 00 00 00 00 00 00 00 00 00 00 00 00 00 00 00 00 00 00 00 00 00 00 00 00 09
09 00 00 00 00 00 00 00 05 05 05 05 05 00 00 00 00 00 00 00 00 00 00 00 00 00 00 00 00 00 00 00 00 00 00 02 00 00 00 09
09 00 00 00 00 00 00 00 05 05 05 05 05 00 00 00 00 00 00 10 00 00 00 00 00 00 00 00 00 00 00 00 00 00 00 02 00 00 00 09
09 00 00 00 00 00 00 00 00 00 00 00 00 00 00 00 00 00 00 00 00 00 00 00 00 00 00 00 00 00 00 00 00 00 00 02 00 00 00 09
09 00 00 00 00 00 00 00 05 05 05 05 05 00 00 00 00 00 00 00 00 00 00 00 00 00 00 00 00 00 00 05 05 07 05 02 00 00 00 09
09 00 00 00 00 00 00 00 05 05 07 05 05 00 00 00 00 00 00 00 00 00 00 00 00 00 00 00 00 00 00 00 00 00 00 00 00 00 00 09
09 05 05 02 05 05 00 00 05 05 02 05 05 00 00 00 00 00 00 00 00 00 00 00 00 00 00 00 00 00 00 00 00 00 00 00 00 00 00 09
09 07 05 05 05 05 00 00 05 05 02 05 05 00 00 00 00 00 00 05 07 05 05 00 00 00 00 00 00 00 00 00 00 00 00 00 00 00 00 09
09 05 05 05 05 05 00 00 00 00 00 00 00 00 00 00 00 00 00 05 02 05 05 00 00 00 00 00 00 00 00 00 00 00 00 00 00 00 02 09
09 00 00 00 00 00 00 00 05 05 02 07 05 00 00 00 00 00 00 05 05 05 05 00 00 00 00 00 00 00 00 00 00 00 00 00 00 00 00 09
09 09 09 09 09 09 09 09 09 09 09 09 09 09 09 09 09 09 09 09 09 09 09 09 09 09 09 09 09 09 09 09 09 09 09 09 09 09 09 09
