20 40
100
700
1000
09 09 09 09 09 09 09 09 09 09 09 09 09 09 09 09 09 09 09 09 09 09 09 09 09 09 09 09 09 09 09 09 09 09 09 09 09 09 09 09
09 01 00 00 00 00 00 00 00 00 00 00 00 00 00 00 00 00 00 00 00 00 00 00 00 00 00 00 00 00 00 00 00 00 05 00 04 04 00 09
09 00 00 00 00 00 00 00 00 00 00 00 00 00 00 05 00 00 00 00 00 00 00 00 00 00 00 00 05 00 00 05 00 00 00 00 00 02 02 09
09 03 03 03 03 03 03 00 00 00 00 00 00 00 00 05 00 00 00 00 00 00 00 05 00 00 00 00 00 00 00 00 00 03 03 03 03 03 03 09
09 00 00 02 02 04 04 03 03 03 03 03 03 00 00 00 00 00 00 00 00 03 03 03 03 03 03 00 00 00 00 00 00 00 00 00 05 00 00 09
09 00 00 04 04 00 00 00 00 00 00 02 00 00 00 00 00 03 03 03 00 00 00 00 00 00 00 00 00 05 05 05 05 05 07 04 00 00 00 09
09 00 00 04 00 00 00 03 03 03 03 03 03 00 00 00 00 00 00 00 00 00 00 00 00 00 00 03 03 03 03 03 03 00 00 00 00 00 00 09
09 00 00 04 00 00 00 00 00 00 00 00 00 00 00 00 00 00 00 04 00 03 03 03 03 03 03 00 00 00 00 04 00 00 00 04 00 04 02 09
09 02 00 00 00 00 00 00 00 00 00 00 00 00 00 00 05 04 00 04 00 10 00 00 00 00 00 00 00 00 00 00 00 00 00 00 00 04 02 09
09 02 04 00 04 00 02 00 00 03 00 00 00 00 00 00 00 00 05 04 00 00 00 04 05 04 00 04 00 00 00 00 00 03 03 03 03 03 00 09
09 00 00 00 04 00 02 00 00 03 00 03 03 03 03 03 03 00 02 04 00 00 02 04 04 02 00 02 04 00 00 00 04 00 00 00 00 00 00 09
09 00 00 02 00 00 00 00 00 03 00 00 00 00 02 02 00 00 00 04 00 05 00 04 00 00 00 02 00 00 02 00 02 03 03 03 00 00 00 09
09 00 04 00 04 00 04 03 03 03 03 00 00 00 02 00 00 00 00 02 00 00 00 05 05 05 00 00 00 00 04 00 05 05 05 00 05 00 00 09
09 00 04 00 04 00 02 00 00 00 00 00 00 00 00 00 00 00 02 02 00 00 00 00 00 00 00 00 00 04 04 00 05 05 05 00 00 00 04 09
09 04 04 02 00 00 02 00 00 00 00 00 00 05 05 05 00 00 00 00 00 05 02 00 00 00 00 04 00 00 00 00 05 05 05 00 04 00 00 09
09 02 02 00 00 00 02 00 00 00 00 00 00 05 05 05 00 00 00 00 00 05 00 00 00 00 00 00 04 04 00 00 00 00 00 00 00 00 00 09
09 00 02 00 00 00 00 00 00 00 00 00 00 05 07 05 00 00 00 05 05 05 05 00 00 00 00 00 00 00 00 00 00 00 00 00 00 04 00 09
09 00 02 00 00 00 00 00 00 00 00 00 00 05 05 05 00 00 00 05 05 05 05 00 00 00 00 00 00 00 00 00 00 00 00 00 02 04 02 09
09 00 00 00 00 00 00 00 00 00 00 00 02 00 00 00 00 00 00 05 05 06 05 00 00 00 00 00 00 00 00 00 00 00 00 00 00 00 02 09
09 09 09 09 09 09 09 09 09 09 09 09 09 09 09 09 09 09 09 09 09 09 09 09 09 09 09 09 09 09 09 09 09 09 09 09 09 09 09 09
