20 40
90
390
3
09 09 09 09 09 09 09 09 09 09 09 09 09 09 09 09 09 09 09 09 09 09 09 09 09 09 09 09 09 09 09 09 09 09 09 09 09 09 09 09
09 05 05 05 05 04 01 00 00 00 00 00 00 00 00 00 00 03 00 02 00 00 00 00 00 00 00 00 00 00 03 00 03 00 00 00 00 00 00 09
09 05 05 07 05 00 00 00 00 04 00 05 00 00 00 00 00 00 00 00 00 00 00 00 00 00 00 00 00 00 00 00 00 00 00 00 00 00 00 09
09 05 05 05 05 00 00 00 00 04 05 05 00 00 00 00 00 00 04 00 00 04 00 00 04 04 00 00 00 04 04 04 00 00 00 00 00 00 00 09
09 00 00 00 00 00 00 00 05 04 00 00 00 00 00 00 00 00 00 00 00 04 00 00 04 04 00 00 00 04 00 00 00 00 00 00 00 00 00 09
09 05 00 00 00 00 00 00 05 00 04 00 00 00 00 00 00 00 00 00 00 04 00 00 04 04 00 00 00 04 04 00 00 00 06 00 00 00 00 09
09 05 00 00 00 00 00 00 05 00 00 04 04 04 04 04 04 00 00 00 00 00 00 00 00 00 00 00 00 00 00 04 00 00 00 00 00 00 00 09
09 05 00 00 00 00 00 05 05 05 00 00 04 00 00 00 00 00 00 00 00 00 00 00 00 00 00 00 00 00 00 00 00 00 00 00 00 00 00 09
09 06 00 00 00 05 05 05 06 05 05 05 00 00 00 00 00 00 00 00 00 00 00 00 00 00 00 05 05 05 00 00 00 00 00 00 00 00 00 09
09 00 00 00 00 00 00 05 05 05 00 00 00 00 00 00 00 00 03 00 00 00 00 00 00 00 00 05 05 05 00 00 00 00 04 00 00 00 00 09
09 04 05 05 00 00 00 00 05 00 00 00 00 00 00 00 00 03 00 03 00 00 02 00 00 00 00 00 00 00 00 00 04 04 04 00 00 00 00 09
09 00 05 05 00 00 00 00 05 00 00 00 00 00 00 00 00 00 03 03 00 00 02 00 00 03 00 00 00 00 00 00 00 00 00 00 00 00 00 09
09 00 00 00 00 00 08 00 05 00 04 00 00 00 00 00 00 02 02 02 00 00 02 00 00 03 00 00 00 00 05 05 05 05 05 00 00 00 00 09
09 00 05 05 00 00 00 00 00 00 00 00 00 00 00 00 00 02 02 02 00 00 00 03 03 03 00 00 00 00 05 07 05 05 05 00 00 00 00 09
09 00 00 00 00 00 05 00 00 04 00 00 00 00 00 00 00 02 00 00 00 00 00 00 00 00 00 00 00 00 05 05 05 05 05 00 00 00 00 09
09 00 00 00 00 00 00 00 00 00 00 00 00 00 00 00 00 00 02 02 00 00 00 00 00 00 00 00 00 00 05 05 05 05 05 00 00 00 00 09
09 00 00 00 00 00 00 00 00 00 00 00 00 00 00 00 00 00 00 00 00 00 00 00 00 00 00 00 00 00 00 00 00 00 00 00 00 00 00 09
09 00 00 00 00 00 05 00 00 00 05 00 00 00 00 04 04 00 00 00 00 00 00 00 00 00 00 00 00 00 00 00 00 00 00 00 00 00 00 09
09 00 00 00 00 00 00 00 00 00 05 00 00 00 00 00 04 00 00 00 00 00 00 00 00 00 00 00 00 04 04 04 04 00 00 00 00 10 00 09
09 09 09 09 09 09 09 09 09 09 09 09 09 09 09 09 09 09 09 09 09 09 09 09 09 09 09 09 09 09 09 09 09 09 09 09 09 09 09 09
