20 40
25
30
1000
09 09 09 09 09 09 09 09 09 09 09 09 09 09 09 09 09 09 09 09 09 09 09 09 09 09 09 09 09 09 09 09 09 09 09 09 09 09 09 09
09 01 00 00 00 00 00 00 00 00 00 00 00 00 00 05 00 00 00 00 00 00 00 00 00 00 00 00 00 00 00 00 00 00 00 00 00 00 00 09
09 00 00 00 00 00 00 00 00 00 00 00 00 00 00 05 00 00 00 00 00 00 00 00 00 00 00 00 00 00 00 00 00 00 00 00 00 00 00 09
09 04 05 05 05 05 05 05 05 05 05 05 05 05 05 05 05 05 07 05 05 05 05 05 05 05 05 05 05 05 05 05 05 05 07 05 05 04 04 09
09 00 05 00 00 05 00 00 00 00 00 05 00 00 00 00 00 00 00 05 00 00 00 00 00 00 00 00 00 00 00 00 00 00 00 00 05 00 02 09
09 04 05 05 05 05 05 05 05 05 05 05 05 05 05 05 05 07 05 05 05 05 05 05 05 05 05 05 05 05 05 05 05 05 05 05 05 04 04 09
09 00 05 00 00 05 00 00 00 00 00 05 00 00 00 00 00 00 00 05 00 00 00 00 00 00 00 00 00 00 00 00 00 00 00 00 05 00 00 09
09 04 05 05 05 05 05 05 05 05 05 05 05 06 05 05 05 05 05 05 05 05 05 05 07 05 05 05 05 05 05 05 05 05 05 07 05 04 04 09
09 00 05 00 00 05 00 00 00 00 00 05 00 00 00 06 00 00 00 05 00 00 00 00 00 00 00 00 00 00 00 00 00 00 00 00 00 04 04 09
09 04 05 05 05 05 05 05 05 05 05 05 05 05 05 05 05 05 05 05 05 05 05 05 05 05 05 05 05 05 05 05 05 05 05 05 05 00 00 09
09 00 05 00 00 05 00 00 00 00 00 05 00 00 00 00 00 00 00 05 00 00 00 00 00 00 00 00 00 10 00 00 00 00 00 00 00 00 00 09
09 02 05 05 05 05 05 07 05 05 05 05 05 05 05 05 05 05 05 05 05 05 05 05 05 05 05 05 05 05 05 05 05 05 05 05 05 00 00 09
09 00 05 00 00 05 00 00 00 00 00 05 00 00 00 00 00 00 00 05 00 00 00 00 00 00 00 00 00 00 00 00 00 00 00 00 00 00 00 09
09 02 05 05 05 05 05 05 05 05 05 05 05 05 05 05 05 05 05 05 05 05 05 05 05 05 05 05 05 05 05 05 05 05 05 05 05 00 00 09
09 00 05 00 00 05 00 00 00 00 00 05 00 00 00 00 00 00 00 05 00 00 00 00 00 00 00 00 00 00 00 00 00 00 00 00 00 00 00 09
09 00 05 05 07 05 05 05 05 05 05 05 05 05 05 05 05 05 05 05 05 05 05 05 05 05 05 05 05 05 05 05 05 05 05 05 05 00 00 09
09 00 04 00 00 00 00 00 00 00 00 05 00 00 00 00 00 00 00 05 00 00 00 00 00 00 00 00 00 00 00 00 00 00 00 00 00 00 00 09
09 04 05 05 05 05 05 05 05 05 05 05 05 05 05 05 05 05 05 05 05 05 05 05 05 05 05 05 05 05 05 05 07 05 05 05 05 00 02 09
09 00 00 00 00 00 00 00 00 00 00 00 02 00 00 00 00 00 00 00 04 00 02 00 00 00 00 00 00 00 00 00 00 00 00 00 00 00 00 09
09 09 09 09 09 09 09 09 09 09 09 09 09 09 09 09 09 09 09 09 09 09 09 09 09 09 09 09 09 09 09 09 09 09 09 09 09 09 09 09
