40 80
200
1500
1000
9 9 9 9 9 9 9 9 9 9 9 9 9 9 9 9 9 9 9 9 9 9 9 9 9 9 9 9 9 9 9 9 9 9 9 9 9 9 9 9 9 9 9 9 9 9 9 9 9 9 9 9 9 9 9 9 9 9 9 9 9 9 9 9 9 9 9 9 9 9 9 9 9 9 9 9 9 9 9 9
9 1 0 0 0 0 0 0 0 0 0 0 0 0 0 0 0 3 2 3 0 0 0 0 0 0 0 0 0 0 3 0 3 0 0 0 0 0 0 2 0 0 0 0 0 0 0 0 0 0 4 4 2 0 0 3 0 2 0 0 4 4 2 0 0 0 0 0 3 0 3 0 0 4 0 4 0 0 0 9
9 4 0 0 0 0 0 0 0 0 0 0 0 0 0 0 0 3 2 3 0 0 0 0 0 0 0 0 0 0 3 0 3 0 0 0 0 0 4 4 0 0 0 0 0 0 0 0 2 0 2 4 4 0 0 3 0 2 4 4 2 2 2 2 0 0 0 0 3 0 3 0 4 2 4 2 4 0 0 9
9 4 0 0 0 0 0 0 0 0 0 0 0 5 5 7 0 3 2 3 0 0 0 0 0 0 0 0 0 0 3 0 3 0 0 0 0 0 0 0 2 0 0 0 0 2 0 0 0 0 2 0 0 0 0 3 0 4 0 0 4 4 4 2 0 0 0 0 3 0 3 0 4 2 0 2 4 0 0 9
9 4 0 0 0 0 0 0 0 0 0 0 0 2 2 2 0 3 2 3 0 0 0 0 0 0 0 0 0 0 3 0 3 0 0 0 0 0 2 2 0 0 0 0 4 4 4 4 0 0 0 0 0 0 0 3 0 4 0 0 0 0 0 0 0 0 0 0 3 0 3 0 0 2 0 2 0 0 0 9
9 4 0 0 0 0 0 0 0 0 0 0 0 5 5 7 0 3 0 3 0 0 0 0 0 0 0 0 0 0 3 0 3 0 0 4 4 0 0 0 3 3 3 3 3 3 0 0 0 3 3 3 3 3 0 3 0 2 0 0 0 0 0 0 0 0 0 0 3 0 3 2 2 0 0 0 2 2 2 9
9 4 0 0 0 0 0 0 0 0 0 0 0 5 5 5 0 3 7 3 0 0 0 0 0 0 0 0 0 0 3 0 3 0 0 0 0 0 0 0 0 0 0 0 0 0 0 0 0 0 0 0 0 0 0 3 0 2 0 0 0 0 0 0 0 0 0 0 3 0 3 0 0 0 0 0 0 0 0 9
9 4 0 0 0 0 0 0 0 0 0 0 0 0 0 0 0 3 5 3 0 0 0 0 0 0 0 0 0 0 3 0 3 0 0 0 0 0 0 0 4 4 0 2 0 0 0 0 0 0 0 0 0 0 0 3 0 2 0 0 0 0 0 0 3 3 3 3 3 0 3 0 0 0 0 0 0 0 0 9
9 4 0 0 0 0 0 0 0 0 0 0 0 0 0 0 0 3 5 3 0 4 4 4 0 0 4 4 4 0 3 0 3 0 0 0 0 0 0 0 0 0 0 4 4 0 0 0 4 4 0 0 0 0 0 3 0 4 0 0 0 0 0 0 0 0 2 4 3 0 3 0 0 0 0 0 0 0 0 9
9 2 0 0 0 0 0 0 0 0 0 0 0 0 0 0 0 3 5 3 0 4 2 4 0 0 4 2 4 0 3 6 3 0 0 0 0 4 4 0 0 0 0 0 0 0 0 0 0 0 4 4 0 0 0 3 0 4 0 0 0 0 0 0 0 2 3 3 3 0 3 0 0 4 0 0 0 0 4 9
9 0 0 0 0 0 0 0 0 0 0 0 0 0 0 0 0 3 5 3 0 4 2 4 0 0 4 2 4 0 3 5 3 0 0 0 0 0 0 0 0 0 0 4 4 0 0 0 0 0 0 0 0 0 0 3 0 4 0 0 0 0 0 0 2 3 4 4 3 0 3 0 0 4 2 0 0 2 4 9
9 0 0 0 0 0 0 0 0 0 0 0 0 0 0 0 0 3 5 3 0 0 2 0 0 0 0 2 0 0 3 5 3 0 0 0 0 0 0 0 0 0 0 0 0 0 0 0 4 4 0 0 4 4 0 3 0 4 0 0 0 0 0 2 3 2 2 2 3 0 3 0 0 0 2 0 0 2 0 9
9 0 0 0 0 0 0 0 0 0 0 0 0 0 0 0 0 3 5 3 0 0 0 0 0 0 0 0 0 0 3 5 3 0 0 0 0 0 0 0 4 4 0 0 0 0 4 4 0 0 0 0 0 0 0 3 0 2 0 0 0 0 0 3 2 2 4 2 3 0 3 0 0 0 2 0 0 2 0 9
9 0 0 0 0 0 0 0 0 0 0 0 0 0 0 0 0 3 5 3 0 0 0 0 0 0 0 0 0 0 3 5 3 0 0 0 0 0 0 0 0 0 4 4 0 0 0 0 0 0 0 0 0 0 0 3 0 2 0 0 0 0 3 0 0 0 0 0 3 0 3 0 0 0 0 0 0 0 0 9
9 0 0 0 0 0 0 0 0 0 0 0 0 0 0 0 0 3 5 3 0 0 0 0 0 0 0 0 0 0 3 5 3 0 0 0 0 0 4 4 0 0 0 0 4 4 0 0 0 0 0 0 0 0 0 3 0 2 0 0 0 0 0 0 0 0 0 0 3 0 3 0 0 0 0 0 0 0 0 9
9 0 0 0 0 0 0 0 0 0 0 0 0 0 0 0 0 3 5 3 0 0 0 0 0 0 0 0 0 0 3 5 3 0 0 0 0 0 0 0 0 0 0 0 0 0 0 0 0 0 0 0 0 0 0 3 0 2 0 0 0 0 0 0 0 0 0 0 3 0 3 0 0 0 0 0 0 0 0 9
9 0 0 0 0 0 0 0 0 0 0 0 0 0 0 0 0 3 5 3 0 0 0 0 0 0 0 0 0 0 3 5 3 0 0 0 4 4 4 4 4 0 0 0 0 0 0 0 0 0 0 0 0 0 0 3 0 4 0 0 0 0 0 0 0 0 0 0 3 0 3 0 0 0 0 0 0 0 0 9
9 0 0 0 0 0 0 0 0 0 0 0 0 0 0 0 0 3 5 3 0 0 0 0 0 0 0 0 0 0 3 5 3 0 0 0 0 0 0 0 0 0 0 0 0 0 0 0 0 0 0 0 0 0 0 3 0 4 0 0 0 0 0 0 0 0 0 0 3 0 3 0 0 0 0 0 0 0 0 9
9 0 0 0 0 0 0 4 4 4 0 0 0 0 0 0 0 3 5 3 0 0 0 0 0 0 0 0 0 0 3 2 3 0 0 0 0 0 0 0 0 0 0 0 0 0 0 0 0 0 0 0 0 0 0 0 0 4 0 0 0 0 0 0 0 0 0 0 0 0 0 0 0 0 0 0 0 0 10 9
9 0 0 0 0 0 0 0 0 0 0 0 0 0 0 0 0 3 0 3 0 0 0 0 0 0 0 0 0 0 3 0 3 0 0 0 0 0 0 0 0 0 0 0 0 0 0 0 0 0 0 0 0 0 0 3 0 4 0 0 0 0 0 0 0 0 0 0 3 0 3 0 0 0 0 0 0 0 0 9
9 0 0 0 0 0 0 0 0 0 0 0 0 0 0 0 0 0 0 0 0 0 0 0 0 0 0 0 0 0 0 0 0 0 0 0 0 0 0 0 0 0 0 0 0 0 0 0 0 0 0 0 0 0 0 3 0 2 0 0 0 0 0 0 0 0 0 0 3 0 3 0 0 0 0 0 0 0 0 9
9 4 0 0 0 0 0 0 0 0 0 0 0 0 0 0 0 3 0 3 0 0 0 0 0 0 0 0 0 0 3 0 3 0 0 0 3 3 3 3 3 0 0 3 3 3 3 3 0 0 0 0 0 0 0 3 0 2 0 0 0 0 0 0 0 0 0 0 3 0 3 0 0 4 0 4 0 0 0 9
9 4 0 0 0 0 0 0 0 0 0 0 0 0 0 0 0 3 5 3 0 0 0 0 0 0 0 0 0 0 3 0 3 0 0 0 0 0 0 0 0 0 0 0 0 0 0 0 0 0 3 3 3 3 3 3 0 2 0 0 0 0 0 0 0 0 0 0 3 0 3 0 0 2 0 2 0 0 0 9
9 4 0 2 0 0 0 0 0 0 0 0 0 0 0 0 0 3 5 3 0 0 0 0 0 0 0 0 0 0 3 0 3 0 0 0 0 0 3 3 3 3 3 0 0 0 0 0 0 0 0 0 0 0 0 3 0 2 0 0 0 0 0 0 0 0 0 0 3 0 3 0 0 2 5 2 0 0 0 9
9 4 2 2 0 0 0 0 0 0 0 0 0 0 0 0 0 3 5 3 0 0 0 0 0 0 0 0 0 0 3 0 3 0 0 0 0 0 0 0 0 0 0 3 3 3 3 3 0 0 0 0 0 0 0 3 0 2 0 0 0 0 0 0 0 0 0 0 3 0 3 0 0 2 7 2 0 0 0 9
9 4 0 2 0 0 4 0 0 0 0 0 0 0 0 0 0 3 5 3 0 0 0 0 0 0 0 0 0 0 3 0 3 0 0 0 0 0 0 0 0 0 0 0 4 0 0 0 0 0 0 0 0 0 0 3 0 2 0 0 0 0 0 0 0 0 0 0 3 0 3 0 0 2 2 2 0 0 0 9
9 4 2 0 0 4 4 4 0 0 0 0 0 0 0 0 0 3 5 3 3 3 3 3 3 0 3 3 3 3 3 2 3 0 0 0 0 0 0 0 0 0 0 0 4 0 0 0 0 0 3 3 3 3 3 3 0 2 0 0 0 0 0 0 0 0 0 0 3 0 3 0 0 0 0 0 0 0 0 9
9 4 0 2 0 0 2 0 0 0 0 0 0 0 0 0 0 3 5 3 4 2 2 2 4 0 4 2 2 2 3 5 3 0 0 0 0 0 0 0 0 0 0 0 0 0 0 0 0 0 0 0 0 0 0 3 0 2 0 0 0 0 0 0 0 0 0 0 3 0 3 0 0 0 0 0 0 0 0 9
9 2 0 0 0 0 2 0 0 0 0 0 0 0 0 0 0 3 5 3 4 0 0 0 4 0 4 0 0 0 3 5 3 0 0 0 0 0 0 3 3 3 3 3 2 3 3 3 3 3 0 0 0 0 0 3 0 4 0 0 0 0 0 0 0 0 0 0 3 0 3 0 0 0 0 0 0 0 0 9
9 0 0 0 0 0 0 0 0 0 0 0 0 0 0 0 0 3 5 3 2 0 0 0 0 0 0 0 0 0 3 5 3 0 0 0 0 0 0 0 0 0 0 0 0 0 0 0 0 4 0 0 0 0 0 3 0 4 0 0 0 0 0 0 0 0 0 0 3 0 3 0 0 0 0 0 0 0 0 9
9 0 0 0 0 0 0 0 0 0 0 0 0 0 0 0 0 3 5 3 0 0 0 0 0 0 0 4 2 4 3 5 3 0 0 0 0 0 0 0 4 0 0 0 4 0 0 0 4 2 4 0 0 0 0 3 0 2 0 4 0 0 0 0 0 0 0 0 3 0 3 0 0 0 0 0 0 0 0 9
9 0 0 0 0 0 0 0 0 0 0 0 0 4 4 0 0 3 7 3 0 0 4 4 0 0 0 4 2 4 3 5 3 0 0 0 0 0 0 4 2 4 0 4 0 4 0 4 2 2 2 4 0 0 0 3 0 2 0 2 4 4 0 0 0 2 2 2 3 0 3 0 0 0 0 0 0 0 4 9
9 0 0 0 0 0 0 0 0 0 0 0 4 2 2 4 0 3 0 3 0 0 4 4 0 0 0 2 2 2 3 5 3 0 0 0 0 0 4 2 2 2 4 0 0 0 4 0 0 0 0 0 4 0 0 3 0 2 0 2 2 2 0 2 2 0 0 0 3 0 3 0 0 0 0 0 0 2 0 9
9 0 0 0 0 0 0 0 0 0 4 4 0 0 3 3 3 3 2 3 0 0 2 2 0 0 0 0 0 0 3 5 3 0 0 0 0 0 0 0 0 0 0 0 4 0 0 0 0 0 0 0 0 0 0 3 0 4 0 0 2 0 0 0 0 2 2 2 3 0 3 0 0 0 0 0 4 0 0 9
9 0 0 0 0 0 0 0 0 4 4 2 4 0 4 2 4 3 2 3 0 0 0 0 0 0 0 0 0 0 3 6 3 0 0 0 0 0 0 0 0 0 0 4 2 4 0 0 0 0 0 0 0 0 0 3 0 4 0 0 0 0 0 0 0 0 0 0 3 0 3 0 0 0 0 2 0 0 4 9
9 0 0 0 0 0 0 0 0 0 2 2 0 0 4 0 2 3 2 3 0 0 0 0 0 0 0 0 0 0 3 0 3 0 0 0 0 0 0 0 0 0 4 2 2 2 4 0 0 0 0 0 0 0 0 3 0 2 0 0 0 0 0 0 0 0 0 0 3 0 3 0 0 0 4 0 0 2 0 9
9 0 0 0 0 0 0 0 0 0 0 0 0 0 0 0 0 3 2 3 0 0 0 0 0 0 0 0 0 0 3 0 3 0 0 0 0 0 0 0 0 4 2 2 2 2 2 4 0 0 0 0 0 0 0 3 0 2 0 0 0 0 0 0 0 0 0 0 3 0 3 0 0 2 0 0 2 0 0 9
9 0 0 0 0 0 0 0 0 0 0 0 0 0 4 3 3 3 0 3 0 0 0 0 0 0 0 0 0 0 3 0 3 0 0 0 0 0 0 0 4 0 0 0 0 0 0 0 4 0 0 0 0 0 0 3 0 2 0 0 0 0 0 0 0 0 0 0 3 0 3 0 4 0 0 2 0 4 2 9
9 0 0 0 0 0 0 0 0 0 0 0 0 0 0 0 2 3 0 2 0 0 0 0 0 0 0 0 0 0 3 0 3 0 0 0 0 0 0 0 0 0 0 0 0 0 0 0 0 0 0 0 0 0 0 3 0 2 0 0 0 0 0 0 0 0 0 0 3 0 3 2 0 0 4 0 0 2 0 9
9 9 9 9 9 9 9 9 9 9 9 9 9 9 9 9 9 9 9 9 9 9 9 9 9 9 9 9 9 9 9 9 9 9 9 9 9 9 9 9 9 9 9 9 9 9 9 9 9 9 9 9 9 9 9 9 9 9 9 9 9 9 9 9 9 9 9 9 9 9 9 9 9 9 9 9 9 9 9 9
