20 40
90
390
3
09 09 09 09 09 09 09 09 09 09 09 09 09 09 09 09 09 09 09 09 09 09 09 09 09 09 09 09 09 09 09 09 09 09 09 09 09 09 09 09
09 01 00 00 00 00 00 00 00 00 00 00 00 00 00 00 00 03 00 02 00 00 00 00 00 00 00 00 00 00 03 00 03 00 00 00 00 00 00 09
09 04 00 00 04 00 00 00 00 02 00 05 00 00 00 00 00 00 00 00 00 00 00 00 00 05 00 00 00 00 00 00 00 00 00 00 00 00 00 09
09 05 00 00 05 00 00 00 04 02 05 05 00 00 00 00 00 00 04 00 04 04 00 00 04 04 00 00 00 04 04 04 00 00 00 00 00 00 00 09
09 05 00 00 05 00 00 00 05 02 00 00 00 00 00 00 00 00 00 00 05 04 00 00 04 05 00 00 00 04 00 00 00 00 00 00 00 00 00 09
09 05 00 00 05 00 00 00 05 00 04 00 00 00 00 00 00 00 00 00 05 04 00 00 04 05 00 00 00 04 04 00 00 00 06 00 00 00 00 09
09 05 00 00 05 00 00 00 05 00 00 04 04 04 04 04 04 00 00 00 05 00 00 00 00 05 00 00 00 00 00 04 00 00 00 00 00 00 00 09
09 05 00 00 05 00 00 05 05 05 00 00 04 00 00 00 00 00 00 00 05 00 00 00 00 05 00 00 00 00 00 00 00 00 00 00 00 00 00 09
09 05 00 00 05 05 05 05 05 05 05 05 00 00 00 00 00 00 00 00 05 00 00 00 00 05 00 05 05 05 00 00 00 00 00 00 00 00 00 09
09 05 00 00 05 00 00 05 05 05 00 00 00 00 00 00 00 00 03 00 05 00 00 00 00 05 00 05 05 05 00 00 00 00 04 00 00 00 00 09
09 05 05 05 05 00 00 00 05 00 00 00 00 00 00 00 00 03 00 03 05 00 02 00 00 05 00 00 00 00 00 00 04 04 04 00 00 00 00 09
09 05 05 05 05 00 00 00 05 00 00 00 00 00 00 00 00 00 03 03 05 00 02 00 00 05 00 00 00 00 00 00 00 00 00 00 00 00 00 09
09 07 00 00 07 00 08 00 06 00 04 00 00 00 00 00 00 02 02 02 07 00 02 00 00 05 00 00 00 00 05 05 05 05 05 00 00 00 00 09
09 00 05 05 00 00 00 00 00 00 00 00 00 00 00 00 00 02 02 02 00 00 00 03 03 05 00 00 00 00 05 07 05 05 05 00 00 00 00 09
09 00 00 00 00 00 05 00 00 04 00 00 00 00 00 00 00 02 00 00 00 00 00 00 00 07 00 00 00 00 05 05 05 05 05 00 00 00 00 09
09 00 00 00 00 00 00 00 00 00 00 00 00 00 00 00 00 00 02 02 00 00 00 00 00 00 00 00 00 00 05 05 05 05 05 00 00 00 00 09
09 00 00 00 00 00 00 00 00 00 00 00 00 00 00 00 00 00 00 00 00 00 00 00 00 00 00 00 00 00 00 00 00 00 00 00 00 00 00 09
09 00 00 00 00 00 05 00 00 00 05 00 00 00 00 04 04 00 00 00 00 00 00 00 00 00 00 00 00 00 00 00 00 00 00 00 00 00 00 09
09 00 00 00 00 00 00 00 00 00 05 00 00 00 00 00 04 00 00 00 00 00 00 00 00 00 00 00 00 04 04 04 04 00 00 00 00 10 00 09
09 09 09 09 09 09 09 09 09 09 09 09 09 09 09 09 09 09 09 09 09 09 09 09 09 09 09 09 09 09 09 09 09 09 09 09 09 09 09 09
